00000000010000
0E000000010000
11111100111110
00000100000000
00000111100000
00S00000000000
00000001100000
