11100000000000
00110111111100
0E000100000000
11111100111110
00000100000000
00000111111110
00S00000001110
00000001100000
