0000000000000000
0000011111111100
0111100000000000
0100110111111100
010E100100000000
0101111100111111
0101000100000000
0001000111111110
0110S00000001110
1000000001100000
