000000000
000000E00
001111000
000001000
000001000
00S000000
000000011
