#Comment
000000000000000   0
000001111111110  0 #also a comment
0111100000000000
0100110111111100
010E100100000000
0101111100111111
0101000000000000
0001000111111110
0110S00000001110
1000000001100000
